Y M O G G G G G G G G G G G G G G G G G G 
Y M O G G G G G G G G G G G G G G G G G G
Y M O G G G G G C V B G G G G G G G G G G 
Y M O G G G G G J K Z G G C V B X G G G G 
Y M O G G G G G J K Z G G J K Z G X G G G 
Y M O G C V B G J K Z G G J K Z G G G G G 
Y M O G J L Z N J L Z N N J L Z N N G G G 
Y M O G G G G G G G G G G G G G G G G G G
Y M O G G G G G G G G G G G G G G G G G G
P P P P P P P P P P P P P P P P P P P P P
P P P P P P P P P P P P P P P P P P P P P
P P P P P P P Q Q P P P P P P P P P P P P 
P P P P P P Q E E Q P P P P P P P P P P P
P P P P A E E E E E E S P P P P P P P P P
P P P P A S D A S D A S P P P P P P P P P 
P P P P P P P P P P P P P P P P P P P P P
P P P P P P P P P P P P P P P P P P P P P
G G G G G G G G G G G G G G G G G G X G G
G G G G G G G G G G G G G G G G G G X G G
G G G G G G G G G G G G G G G G G G X G G
G G G G G G G G G G G G G G G G G G X G G
G G G G G G G G G G G G G G G G G G X G G
